111111111
1C0000001
100000001
1P0000111
1000001E1
111111111
