111111111
1E0000001
100000001
1P0000111
1000001C1
111111111
