111111111
1E00000P1
1000000C1

100000111
100000001
111111111
