111111110
1E0000001
100000001
1P0000111
1000000C1
111111111
