111111111
1E0000P01
100000001
1P0000111
1000000C1
111111111
