111111111
1E0000001
100000001
1P0000111
100000111
111111111
