11111111111111111111111
1E100000000000000C00001
10101100000000001000001
10101000000000001000001
100010000000P0001000001
11111111111111111111111

