11111111
11E00P01
1C11C1C1
11111111
