11111111
10000000
11111111
11111111
