11111111
10E00P01
1PC1C1C1
11111111
